オマンコォォ	小穴
オマンコッ	小穴
オマンコにっ	小穴
オマンコ肉	蜜肉
オマンコ穴	小穴
メス穴	雌穴
オマンコ	小穴
オマ●コ	小●穴
おま●こ	小●穴
おまんこ	小穴
まんこ	小穴
口マンコ	口穴
マンコ穴	小穴
マンコ肉	蜜肉
マンコ	小穴
オメコ	小穴
おめこ	小穴
キツマン	名器
ミミズ千匹	名器
数の子天井	名器
女陰	小穴
スジまん	白虎小穴
牝壷	淫壶
牝器官	淫欲器官
牝穴	淫穴
膣内射精	内射
膣洞	花径
膣内	花径
膣穴	花径
膣の肉	淫肉
マン肉	蜜肉
肉穴	肉穴
膣肉	淫肉
卑肉	淫肉
雌肉	淫肉
牝肉	淫肉
恥肉	耻肉
媚肉	媚肉
秘肉	秘肉
膣襞	花褶
牝襞	淫褶
肉唇	肉唇
肉びら	肉唇
膣壁	花褶
肉ヒダ	肉褶
ヒダ	肉褶
ヒダヒダ	肉褶
肉ビラ	肉瓣
ビラビラ	肉瓣
ワレメ	肉缝
クリトリス	阴蒂
クリ豆	阴蒂
陰核	阴蒂
淫核	阴蒂
オマメ	小豆豆
クリ	阴蒂
陰部	阴部
女性器	女性生殖器
ポルチオ	子宫颈
Ｇスポット	Ｇ点
ディルドー	假阳具
ディルド	假阳具
乳房の谷間	乳沟
乳肉	乳肉
乳デカ	巨乳
生乳房	裸乳
オッパイオナホ	奶子飞机杯
デカパイ	巨乳
乳肌	乳肉
乳突起	乳头
生乳	裸乳
おっぱい	奶子
オッパイ	奶子
陥没乳首	陷没乳头
乳頭	乳头
ニップル	乳头
乳首	乳头
乳暈	乳晕
乳輪	乳晕
ケツマンコセックス	屁穴做爱
アナルセックス	肛交
アナルファック	肛交
オナホアナル	屁穴飞机杯
お尻の穴	屁穴
尻の穴	屁穴
アナル	屁穴
尻穴	屁穴
ケツマンコ	屁穴
ケツの穴	屁穴
ケツ穴	屁穴
菊穴	菊穴
菊座	菊部
尻肌	臀肉
尻肉	臀肉
牝尻	淫臀
生尻	裸臀
桃尻	蜜桃臀
恥液	耻液
恥汁	耻液
雌汁	淫水
牝汁	淫水
絶頂液	绝顶汁
絶頂汁	绝顶汁
マン汁	蜜汁
お、オチンチン	鸡鸡
おちんちん	鸡鸡
オチンチン	鸡鸡
オチンチンッ	鸡鸡
オチンチ	鸡鸡
チンコ	鸡鸡
チンチン	鸡鸡
粗チン	短小包茎
巨チン	鸡鸡
ちんちん	鸡鸡
陰茎	阴茎
いんけい	阴茎
ペニス	阴茎
だんせいき	阴茎
だんこん	阴茎
男根	阴茎
男性器	阴茎
魔羅	阴茎
牡竿	阴茎
肉棍	肉棒
肉柱	肉棒
肉竿	肉棒
肉幹	肉棒
オチンポ	肉棒
チンポ	肉棒
オチ●ポ	肉●棒
おち●ぽ	肉●棒
チ●ポ	肉●棒
太幹	巨根
竿肌	竿肌
竿	竿
亀頭	龟头
雁首	龟头
カリ首	龟头
きとう	龟头
鈴口	龟头
カリ裏	龟头内侧
カリ	冠状沟
おタマタマ	蛋蛋
キンタマ	蛋蛋
タマタマ	蛋蛋
金玉	睾丸
裏筋	系带
ザーメン	精液
スペルマ	精液
せーえき	精液
牡汁	精液
雄汁	精液
子種汁	精液
精の弾丸	精子
子種	精子
包茎	包茎
チンカス	包皮垢
我慢汁	忍耐汁
ガマン汁	忍耐汁
がまん汁	忍耐汁
先走り汁	先走汁
カウパー液	先走汁
カウパー汁	先走汁
先走り	先走汁
カウパー	先走汁
オナホール	飞机杯
オナホ	飞机杯
電マ	电动按摩棒
でんま	电动按摩棒
電動マッサージ機	电动按摩棒
振動棒	振动棒
バイブ	振动棒
ローター	跳蛋
クリップ	夹子
プラグ	塞子
ローション	润滑液
パール	拉珠
オナって	自慰
オナニー	自慰
まんずり	自慰
自慰	自慰
クンニリングス	舔阴
髪コキ	发交
イラマチオ	深喉
パイズリ	乳交
パイずり	乳交
足コキ	足交
奉仕	侍奉
クンニ	舔阴
シックスナイン	69式
素股	素股
キスハメ	接吻做爱
セ、セックス	做爱
セックス	做爱
エッチ	H
ファック	操
レイプ	强奸
種付け	播种
種付	播种
中出し	中出
中出	中出
ぶっかけて	颜射
ぶっかける	颜射
潮吹き	潮吹
潮噴き	潮吹
フェラチオ	口交
口戯	口交
フェラ	口交
ウレション	漏尿
うれしょん	漏尿
抽送	抽送
ずぼずぼ	抽插
しごかれて	套弄
しごかれる	套弄
しごいた	套弄
しごいて	套弄
しごかれ	套弄
しごけて	套弄
しごける	套弄
しごき	套弄
しごく	套弄
しごけ	套弄
虐めて	欺负
仕置	惩罚
しおき	惩罚
責めが	责弄
責めで	责弄
責める	责弄
責め	责弄
犯して	侵犯
犯し	侵犯
ご主人様	主人
ご主人	主人
マスター	主人
主人	主人
コイツら	这些家伙
こいつ	这家伙
コイツ	这家伙
そいつ	那家伙
オヤジ	老爹
おやじ	老爹
オヤジさん	老爹
爺さん	爷爷
おじいちゃん	爷爷
おじさま	叔叔
おじさん	大叔
おっさん	大叔
せんせー	老师
せんせい	老师
センセイ	老师
せんせぇ	老师
せんせ	老师
先生	老师
サキュバス	魅魔
サッキュバス	魅魔
痴漢	痴汉
小便	小便
オシッコ	小便
おしっこ	小便
お小水	小便
小水	小便
肉便器	肉便器
便器	便器
マゾヒスト	抖Ｍ
ドＭ	抖Ｍ
マゾな	抖Ｍ的
マゾ	抖Ｍ
マゾ牝	抖M母狗
マゾヒスティックな	受虐性的
サディスティックな	虐待性的
サディスティックに	虐待性的
サディスト	虐待狂
スタンガン	电击枪
バージン	处女
結合部	交合处
ヒロイン	女主角
危険日	危险日
赤ちゃん	小宝宝
ハーレム	后宫
腹ポコ	西瓜肚
腹ボテ	西瓜肚
ボテ腹	西瓜肚
コスプレイヤー	Coser
コスプレ	Cosplay
ズリネタ	配菜
オカズ	配菜
おかず	配菜
オナネタ	配菜
雌犬	母狗
牝犬	母狗
メス犬	母狗
スケベ牝	淫乱女
淫乱牝	淫乱女
豚女	母猪
性奴隷	性奴隶
性奴	性奴
牝奴隷	性奴
スレイブ	奴隶
奴隷	奴隶
ダッチワイフ	性爱娃娃
万力	老虎钳
ドスケベ	超骚
スケベ	色鬼
スクール水着	死库水
スク水	死库水
水着	泳装
アンスコ	打底裤
ショーツ	短裤
Ｔバック	丁字裤
パンツ	内裤
タイツ	紧身裤
ブルマ	运动裤
ストッキング	连裤袜
ニーソック	过膝袜
レギンス	紧身裤
パンスト	连裤袜
ランジェリー	内衣
パーカー	风衣
セーラー服	水手服
部屋着	居家服
ボンデージ	紧缚衣
ホルターネック	系绳露背装
下着	内衣
バニースーツ	兔女郎装
アクメェェ	高潮了
アクメ	绝顶
アソコ	那里
あそこ	那里
イックゥウウッ	\要
イ、イク	\要
イクぞっ	要去了
イクう	要去了
イクッ	要去了
イクのっ	要去了
イク	要去了
気持ちよくなっちゃうなんてっ	太舒服了
気持ちよくぅっ	好舒服
気持ちいいっ	好舒服
いっぱい感じさせられて	很有感觉了
感じさせられるのっ	有感觉了
感じちゃうっ	有感觉了
ダメッ	不行
ダメェ	不行
ダメ	不行
ヒクつかせ	抽搐
ピクッと	抽搐
マングリ返し	掰腿朝天
まんぐり返し	掰腿朝天
ワシ	本大爷
ピース	比“Ｖ”（和平）
便女	便女
生ハメ	无套做爱
不浄の穴	不洁之穴
だめ	不要
いや	不要
イヤ	不要
いやぁ	不要
ぁああ	啊啊
ああぁ	啊啊
ああん	啊啊
アァ	啊啊
あッ	啊
アッ	啊
あぅ	啊
ひゃあああ	咿呀啊啊
ヒャアアア	咿呀啊啊
ひきゃああ	咿呀啊啊
ヒキャアア	咿呀啊啊
ぎゃああぁ	呀啊啊
ギャアアァ	呀啊啊
ぷあぁ	噗啊
ぷあっ	噗啊
ぷあァア	噗啊
ぷあッ	噗啊
うくぅうっ	咕呜
うくぅうう	咕呜
うくっ	咕呜
ううっ	呜呜
ううう	呜呜
牝共	雌畜们
牝ども	雌畜们
おヘソ	肚脐
ヘソ	肚脐
ファン	粉丝
うんち	粪便
ウンチ	粪便
細腰	柳腰
気持ち、悪いっ	真恶心
ひどい	太过分了
意識トんじゃう	意识飞走
恥ずかしく	丢人
恥ずかしい	丢人
恥ずかし	丢人
ゾクゾク	悸动
いやらしく	下流
いやらしい	下流
センパイ	前辈
ヌルヌル	黏糊糊
ベトベト	黏黏的
グニグニ	很有弹性
ぐにぐに	很有弹性
ふわふわ	软绵绵的
パイパン	白虎
すべすべ	光滑
プニプニ	水嫩
ぷにぷに	水嫩
じわりじわり	慢慢地
ジワリジワリ	慢慢地
牝だ	雌性
牝の	雌性的
牡に	雄性
ベビードール	情趣内衣
腸内	肠内
恥丘	阴阜
絶頂	绝顶
手コキ	手交
手マン	手淫
胎内	胎内
性感帯	性感带
淫具	淫具
淫牝	淫娃
欲棒	欲棒
エロ	工口
エロチックな	工口的
ジャンキー	成瘾症
マニアック	崇拜
生娘	雏娘
真珠	串珠（珍珠）
牝芯	雌芯
オルガスムス	性高潮
クリオナ	阴蒂手淫
寸止め	寸止
ド変態	大变态
内もも	大腿内侧
吊革	吊环
腰使い	动腰法
猿轡	堵嘴物
裏ピース	反手比“Ｖ”
我が君	夫君
ふたなり	扶她
フタナリ	扶她
剛直	刚直
アヘ顔	高潮颜
イキ顔	高潮颜
イク姿	高潮样子
オス豚	公猪
谷間	谷间
官能	官能
スベスベ	光滑
ぬめる	光滑
四つん這い	跪伏
四つんばい	跪伏
膝立ち	跪立
エロい	好色
巾着	荷包
フェロモン	荷尔蒙
フィギュア	花样滑冰
蟻の門渡り	会阴
婚約者	婚约者
生肌	肌肤
ピースサイン	剪刀手
ムッチリして	紧致（丰满）
ムッチリ	紧致（丰满）地
ムッチリした	紧致（丰满）地
ムッチリと	紧致（丰满）地
よくも	竟敢
ギャグ	口枷
おしゃぶり	口淫（奶嘴）
マニア	狂热者
ゴミクズ	垃圾人渣
チアガール	啦啦队少女
フェチ	恋物癖
マニアックな	另类的
グチョグチョだ	乱七八糟
ロリコン	萝莉控
感度	敏感度
母乳噴いち	母乳要喷出来了
牝顔	母猪脸
メス顔	母猪脸
オカマ	男同人妖
メモリ	内存（刻度计）
パンチラ	内裤走光
ビンタ	拍打
ウンコ穴	排泄肉洞
うんち穴	排泄肉洞
箱入り娘	千金闺秀
嬉ション	屈服性失禁
ニップルス	乳贴
ニプルス	乳贴
软肉	软肉
牝粘膜	骚浪粘膜
牝臭い	骚味
クリちゃん	小豆豆
クリチンポ	阴蒂肉棒
スケベ汁	色胚汁
色気	色气
クリリング	阴蒂环
子袋	子袋
ヴァルキリー	女武神
ノーブラ	上身真空
蕩け顔	失神脸
サディズム	施虐欲
締め付けながら	收紧
劣情	兽欲
粗相	疏忽（漏尿）
ネタ	配菜
先っぽ	头部
許婚	未婚夫(妻)
許嫁	未婚夫(妻)
ノーパン	下身真空
ヨダレ	涎液
ゴム	避孕套
ハナタレ	小毛孩
初物	新品
初モノ	新品
高ぶり	兴奋
高ぶる	兴奋
ギンギン	兴奋
よがり	性奋
ヨガリ	性奋
ノロケ	秀恩爱
目尻	眼角
インポ	阳痿
艶っぽい	妖冶的
一発	一发
イチモツ	逸物
スケベなマゾ牝	淫荡抖M母狗
オーク	兽人
スーツ	套装
色っぽ	色情
エロく	色情
舌使い	运舌法
指使い	运指法
前張り	遮羞贴
指の腹	指腹
スケベな	色情的
プライド	自尊
トドメ	最后一击
牝として	作为雌性
艶めかしさ	淫媚
艶めかしく	淫媚地
艶めかしい	淫媚的
物欲しげ	欲求不满
背徳	背德
生の女	新鲜的女人
ビッチ	碧池
極太	超大
へんたい	变态
赤ん坊	小宝宝
たくましい	强壮的
サマだ	大人